# Glossary in tab-separated format -*- coding: utf-8 -*-
vangelo	evangèliu
Figlio	Fizu
Ecco	Acò	(mira / bi·nche)
messaggero	nùntziu
preparerà	at a aprontare	at a ammaniare
raddrizzate	adderetade
Giovanni	Giuanne
battezzare	batizende
predicando	annuntziende	preighende (cat. predicava; eng: preaching)
Accorreva	Acudiat
cintura	chintorza	chintu
fianchi	lumbos	fiancos
chinare	incrinare
uscire	bessire	essire
colomba	columba
compiacere	a tènnere in prètziu
mi sono compiaciuto	ti tenzo in prètziu
prediletto	su prus istimadu
sospinse	ispintu	leadu (Su contu)
tentato	tentadu	aguantende sas tentatziones de sàtana
convertitevi	cunvertide·bos	Torrade·bos a pensare; Su contu: "creide in s'evangèliu"
Andrea	Andria
Giacomo	Giagu
Zebedèo	Zebedeu
Ed	E
scribi	mastros de leze	iscribas
immondo	malu	titule
Nazareno	Nazarenu
straziandolo	pessichinde·lu	trumetende·lu
scacciò	nch'aiat bogadu	aiat zagaradu
ammonendolo	brighende·lu
Mosè	Mosès
quegli	cuddu	Quegli=quello (persona)
pubblicani	publicanos
peccatori	pecadores
farisei	fariseos
otri	udre	buscinu
alcuni	unos cantu	unos / unas
paralitico	màrturu
sappiate	iscais
digiuno	zeunu
grezzo	ruzu	grussu
inaridita	sica
Ma essi tacevano	E cuddos mudos	su contu
per la durezza dei loro cuori	pro cantu fiant coritostos
Ne costituì	nde aiat numenadu	nde aiat fatu
predicare	nuntziare
demoni	dimònios
demòni	dimònios
seduto	sètzidu
Cafarnao	Cafàrnau
Cafarnao	Cafàrnau
per la durezza dei loro cuori	pro comente fiant coriduros
tennero consiglio	fàghere combinu	ordiminzare
dalle parti di	dae sas bandas
Pietro	Pedru
Filippo	Tilipu
reggersi	rezet ritzu	rezet reu
satana	sàtana
moggio	moju
terreno profondo	pizu de terra	terrinu fundudu bastante
intendere	intèndere	ascurtare
parabole	paràbulas
parabola	paràbula
Gerasèni	Gerasenos
figlioletta	fizichedda
Or	como
vantaggio	profetu
impaurita	timende
tremante	tremende·si
udito	intesu
trambustu	badalocu
sapienza	sabiesa
carpentiere	mastru de linna
bastone	bàculu	fuste
scuotete	ischitzinade
infermi	malàidos
lecito	lìtzitu
vigilava	bardaiat
volentieri	cun piaghere
sporte	isportas
risuscitare	resuscitare	torrare bivu
vergognerà	at a birgonzare
peccatrice	pecadora
Orbene	Duncas
schiuma	ispruma
scandalizza	iscàndulit	Ruju / DitzLC
Chiunque	chie si siat
accorrere	acùrrere
scacciarlo	istrajare
ripudiare	dispatzare	zagarare
Dio solo	Deus e issu ebbia	Deus ebbia
fissatolo	iscumpassende·si·lu	abbaidende·si·lu
tesoro	ascusorzu	siddadu
afflitto	iscoradu	aflizidu
cruna di un ago	s'ogru de s'agu	su cossu de s'agu (ctl. cos)
sbigottiti	transidos	transídu , pps, agt: atrassidu, trassidu, trassitu  de transire; nau de ccn., chi est coment'e atontau o ammammalucau de s'ispantu, de sa meravíglia, po cosa chi no s'ibertaiat própriu, bista mai
in disparte	a bandas
scherniranno	ant a inzuriare
addosso	a subra
Rabbunì	Rabbinu
lucerniere	candelobre
senapa	alaussa
Non sta forse scritto	No est a beru chi b'est iscritu	Ello non b'est iscritu
genti	pòpulos
piantò	aiat pastinadu
In verità vi dico	Bos lu naro a beru
prodigio	meràculu
Elia	Elias
Timèo	Timeu
Bartimèo	Bartimeu
atto di ripudio	àutu de refudu	pabiru de refudu
Corazu!	Corazu!	Ajò!
Coraggio!	Corazu!	Ajò!
costruttori	fraigadores	fraigamuros
scartata	iscartadu	lassadu a banda
testata d'angolo	pedra de assentu	RUBATTUpietra angolare sf. [corner stone, pierre
ipocrisia	farsidade	ipocrisia
Gesù Cristo	Gesùs Cristos
Isaia	Isaia
Giudea	Giudea
Gerusalemme	Gerusalemme
Giordano	Giordanu
Nazaret	Nazaret
Galilea	Galilea
Simone	Simone
Davide	Dàvide
Abiatàr	Abiatàr
Boanèrghes	Boanerghes
Tiro	Tiru
Sidone	Sidone
Idumea	Idumea
Matteo	Mateu
Tommaso	Tomasu
Alfeo	Alfeu
Taddeo	Taddeu
Giuda Iscariota	Giudas Iscariota
Beelzebùl	Beelzebùl
Bètfage	Bètfage
Betània	Betània
il monte degli Ulivi	Monte de sas Olias
Cesare	Tzèsare
sadducei	saddutzeos
